"filename", "language", "C++", "comment", "blank", "total"
"d:\Turbo\src\Game\main.cpp", "C++", 44, 2, 8, 54
"d:\Turbo\src\Turbo\Core\Application.cpp", "C++", 115, 5, 19, 139
"d:\Turbo\src\Turbo\Core\Input\InputContext.cpp", "C++", 146, 7, 17, 170
"d:\Turbo\src\Turbo\Core\Input\InputHandle.cpp", "C++", 9, 0, 1, 10
"d:\Turbo\src\Turbo\Core\Input\InputManager.cpp", "C++", 210, 1, 25, 236
"d:\Turbo\src\Turbo\Core\Layers\ImGuiLayer.cpp", "C++", 110, 0, 28, 138
"d:\Turbo\src\Turbo\Core\Layers\Layer.cpp", "C++", 10, 0, 1, 11
"d:\Turbo\src\Turbo\Core\Log.cpp", "C++", 0, 20, 5, 25
"d:\Turbo\src\Turbo\Core\Renderer\imgui_demo.cpp", "C++", 4991, 649, 484, 6124
"d:\Turbo\src\Turbo\Core\Renderer\imgui_impl_opengl3.cpp", "C++", 575, 124, 63, 762
"d:\Turbo\src\Turbo\Core\States\State.cpp", "C++", 36, 0, 6, 42
"d:\Turbo\src\Turbo\Core\Window.cpp", "C++", 172, 7, 45, 224
"Total", "-", 6418, 815, 702, 7935